==                                    ==
==                                    ==
==                                    ==
==                                    ==
==                                    ==
==                                    ==
==---------                 ----------==
==                                    ==
==                                    ==
==                                    ==
==                                    ==
==          ----------------          ==
==                                    ==
==                                    ==
==                                    ==
==      s                    s        ==
==   -------   ===  ===   -------     ==
==                                    ==
==                                    ==
==                                    ==
==     p                              ==
==     ---------        ---------     ==
==                                    ==
==                                    ==
==                                    ==
==                                    ==
==             ----------             ==
==                                    ==
========================================
========================================

