--                                    --
--                                    --
--                                    --
--                                    --
--                                    --
--                                    --
-----------                 ------------
--                                    --
--                                    --
--                                    --
--                                    --
--          ----------------          --
--                                    --
--                                    --
--                                    --
--                                    --
--   -------   ===  ===   -------     --
--                                    --
--                                    --
--                                    --
--                                    --
--                                    --
--                                    --
--     p                              --
--     ---------        ---------     --
--                                    --
--                                    --
--                                    --
----------------------------------------
----------------------------------------